1111111111111
1C01CCC0001C1
1100011010001
1PC1110101E01
1111111111111