1111111111111
100C00000P001
1000000000001
10000E0000001
1000000000001
100C000000001
1111111111111